300111110100111
000000010110101
000101000100001
100011110001100
000100000111000
110101101100011
000111000011001
010001101011000
001010001000110
101001011010010
101011010011001
100010010110001
001010100000100
110110110110111
100000110010002
